1111111111111
1000ECPPP0011
1000000CCCC11
1011110000111
1111000000111
1111111111111
