1111111111111111111111
1000000000000000000001
1111111111111111111011
1EPC000000000010000001
1000000000000000000001
1111100011111110111111
