1111111111111111111111
1000000000000000000001
1111011111111111111101
1EC0000000000010000001
1000000000000000000001
1111111111111111111111
