1111111111111111111111
1000000000000000000001
1111110111111111111101
1CP0000000000010000001
1000000000000000000001
1111111111111111111111
